IfcTubeBundleType	IfcHvacDomain
IfcDiscreteAccessory	IfcSharedComponentElements
IfcShell	IfcTopologyResource
IfcIndexedPolygonalFace	IfcGeometricModelResource
IfcPlanarBox	IfcPresentationDefinitionResource
IfcCurveStyleFontPattern	IfcPresentationAppearanceResource
IfcMotorConnectionTypeEnum	IfcElectricalDomain
IfcLuminousIntensityMeasure	IfcMeasureResource
IfcSpatialElement	IfcProductExtension
IfcThermalTransmittanceMeasure	IfcMeasureResource
IfcFaceOuterBound	IfcTopologyResource
IfcGeographicElementType	IfcProductExtension
IfcNamedUnit	IfcMeasureResource
IfcCurveOrEdgeCurve	IfcGeometricConstraintResource
IfcRelCoversBldgElements	IfcSharedBldgElements
IfcLabel	IfcMeasureResource
IfcLayerSetDirectionEnum	IfcMaterialResource
IfcText	IfcMeasureResource
IfcCompoundPlaneAngleMeasure	IfcMeasureResource
IfcAbsorbedDoseMeasure	IfcMeasureResource
IfcStructuralLoad	IfcStructuralLoadResource
IfcPlaneAngleMeasure_List	Other
IfcFlowInstrumentType	IfcBuildingControlsDomain
IfcDamperTypeEnum	IfcHvacDomain
IfcLaborResourceTypeEnum	IfcConstructionMgmtDomain
IfcAccelerationMeasure	IfcMeasureResource
IfcSweptAreaSolid	IfcGeometricModelResource
IfcSpaceBoundarySelect	IfcProductExtension
IfcPropertyAbstraction	IfcPropertyResource
IfcCoordinateReferenceSystem	IfcRepresentationResource
IfcLampType	IfcElectricalDomain
IfcCartesianTransformationOperator3DnonUniform	IfcGeometryResource
IfcRelDefines	IfcKernel
IfcEvent	IfcProcessExtension
IfcModulusOfSubgradeReactionMeasure	IfcMeasureResource
IfcLightIntensityDistribution	IfcPresentationOrganizationResource
IfcReal	IfcMeasureResource
IfcPlanarForceMeasure	IfcMeasureResource
IfcConversionBasedUnitWithOffset	IfcMeasureResource
IfcPileType	IfcStructuralElementsDomain
IfcPermeableCoveringOperationEnum	IfcArchitectureDomain
IfcRelServicesBuildings	IfcProductExtension
IfcElectricTimeControlTypeEnum	IfcElectricalDomain
IfcReinforcingBarType	IfcStructuralElementsDomain
IfcDoorPanelPositionEnum	IfcArchitectureDomain
IfcFanType	IfcHvacDomain
IfcLabel_List	Other
IfcFeatureElementAddition	IfcProductExtension
IfcProcess	IfcKernel
IfcWorkCalendar	IfcProcessExtension
IfcStairFlightTypeEnum	IfcSharedBldgElements
IfcPropertyReferenceValue	IfcPropertyResource
IfcAirTerminalBoxType	IfcHvacDomain
IfcAirToAirHeatRecoveryType	IfcHvacDomain
IfcTransportElement	IfcProductExtension
IfcCShapeProfileDef	IfcProfileResource
IfcCompressorType	IfcHvacDomain
IfcSoundPressureMeasure	IfcMeasureResource
IfcStructuralCurveAction	IfcStructuralAnalysisDomain
IfcStructuralItem	IfcStructuralAnalysisDomain
IfcBoolean	IfcMeasureResource
IfcProductDefinitionShape	IfcRepresentationResource
IfcStateEnum	IfcUtilityResource
IfcCartesianPointList3D	IfcGeometricModelResource
IfcLampTypeEnum	IfcElectricalDomain
IfcNormalisedRatioMeasure_EmptyList	Other
IfcIntegerCountRateMeasure	IfcMeasureResource
IfcPreDefinedPropertySet	IfcKernel
IfcTableRow_EmptyList	Other
IfcThermalConductivityMeasure	IfcMeasureResource
IfcTimePeriod_EmptyList	Other
IfcProfileTypeEnum	IfcProfileResource
IfcFireSuppressionTerminalTypeEnum	IfcPlumbingFireProtectionDomain
IfcCostValue_List	Other
IfcLengthMeasure_EmptyList	Other
IfcDistributionPortTypeEnum	IfcSharedBldgServiceElements
IfcHeatExchangerTypeEnum	IfcHvacDomain
IfcReinforcingBar	IfcStructuralElementsDomain
IfcPreferredSurfaceCurveRepresentation	IfcGeometryResource
IfcStructuralLoadSingleDisplacementDistortion	IfcStructuralLoadResource
IfcRelAssignsToProduct	IfcKernel
IfcCompositeCurveSegment	IfcGeometryResource
IfcTimeSeriesValue_List	Other
IfcBuildingElementPart	IfcSharedComponentElements
IfcTendon	IfcStructuralElementsDomain
IfcTimeSeries	IfcDateTimeResource
IfcStyledRepresentation	IfcRepresentationResource
IfcFlowTerminalType	IfcSharedBldgServiceElements
IfcProtectiveDevice	IfcElectricalDomain
IfcTransportElementTypeEnum	IfcProductExtension
IfcRatioMeasure_List	Other
IfcDuctSilencer	IfcHvacDomain
IfcCoilTypeEnum	IfcHvacDomain
IfcPointOrVertexPoint	IfcGeometricConstraintResource
IfcExternallyDefinedTextFont	IfcPresentationAppearanceResource
IfcDimensionCount	IfcGeometryResource
IfcPropertyDefinition	IfcKernel
IfcTextureVertexList	IfcPresentationAppearanceResource
IfcParameterValue_List	Other
IfcCircleProfileDef	IfcProfileResource
IfcContext	IfcKernel
IfcGeometricRepresentationItem	IfcGeometryResource
IfcFailureConnectionCondition	IfcStructuralLoadResource
IfcSIUnit	IfcMeasureResource
IfcThermalExpansionCoefficientMeasure	IfcMeasureResource
IfcTextureCoordinate	IfcPresentationAppearanceResource
IfcInterceptor	IfcPlumbingFireProtectionDomain
IfcRelAssociatesLibrary	IfcKernel
IfcFastener	IfcSharedComponentElements
IfcProtectiveDeviceTypeEnum	IfcElectricalDomain
IfcCableCarrierSegmentTypeEnum	IfcElectricalDomain
IfcConnectionCurveGeometry	IfcGeometricConstraintResource
IfcSurfaceStyleShading	IfcPresentationAppearanceResource
IfcCartesianPoint_EmptyList	Other
IfcSurfaceStyleElementSelect	IfcPresentationAppearanceResource
IfcStructuralLoadPlanarForce	IfcStructuralLoadResource
IfcCableCarrierFitting	IfcElectricalDomain
IfcRampFlight	IfcSharedBldgElements
IfcCableFittingType	IfcElectricalDomain
IfcKnotType	IfcGeometryResource
IfcFlowMovingDevice	IfcSharedBldgServiceElements
IfcDoorLiningProperties	IfcArchitectureDomain
IfcComplexProperty	IfcPropertyResource
IfcLShapeProfileDef	IfcProfileResource
IfcCommunicationsApplianceTypeEnum	IfcElectricalDomain
IfcSpecularRoughness	IfcPresentationAppearanceResource
IfcPlane	IfcGeometryResource
IfcProductRepresentationSelect	IfcRepresentationResource
IfcFeatureElementSubtraction	IfcProductExtension
IfcBoundaryCondition	IfcStructuralLoadResource
IfcRectangleHollowProfileDef	IfcProfileResource
IfcShapeModel	IfcRepresentationResource
IfcThermalResistanceMeasure	IfcMeasureResource
IfcSectionedSpine	IfcGeometricModelResource
IfcIndexedTriangleTextureMap	IfcPresentationAppearanceResource
IfcCableCarrierSegmentType	IfcElectricalDomain
IfcLightSourceSpot	IfcPresentationOrganizationResource
IfcBoilerTypeEnum	IfcHvacDomain
IfcUnitaryControlElementType	IfcBuildingControlsDomain
IfcBooleanClippingResult	IfcGeometricModelResource
IfcFontStyle	IfcPresentationAppearanceResource
IfcChillerType	IfcHvacDomain
IfcTranslationalStiffnessSelect	IfcStructuralLoadResource
IfcPhysicalQuantity_EmptyList	Other
IfcRampFlightTypeEnum	IfcSharedBldgElements
IfcPhysicalOrVirtualEnum	IfcProductExtension
IfcTextDecoration	IfcPresentationAppearanceResource
IfcMassMeasure	IfcMeasureResource
IfcDocumentSelect	IfcExternalReferenceResource
IfcBooleanResult	IfcGeometricModelResource
IfcBenchmarkEnum	IfcConstraintResource
IfcCurveStyleFontPattern_EmptyList	Other
IfcTubeBundle	IfcHvacDomain
IfcMaterialLayer	IfcMaterialResource
IfcPlaneAngleMeasure	IfcMeasureResource
IfcFlowInstrumentTypeEnum	IfcBuildingControlsDomain
IfcFurnitureType	IfcSharedFacilitiesElements
IfcMomentOfInertiaMeasure	IfcMeasureResource
IfcCsgSelect	IfcGeometricModelResource
IfcCovering	IfcSharedBldgElements
IfcTypeObject	IfcKernel
IfcZShapeProfileDef	IfcProfileResource
IfcStairFlightType	IfcSharedBldgElements
IfcFlowControllerType	IfcSharedBldgServiceElements
IfcTableColumn_List	Other
IfcSurfaceStyleLighting	IfcPresentationAppearanceResource
IfcDirectionSenseEnum	IfcMaterialResource
IfcSanitaryTerminalTypeEnum	IfcPlumbingFireProtectionDomain
IfcGroup	IfcKernel
IfcAnalysisTheoryTypeEnum	IfcStructuralAnalysisDomain
IfcLightSourceAmbient	IfcPresentationOrganizationResource
IfcResourceObjectSelect	IfcExternalReferenceResource
IfcStructuralSurfaceMemberVarying	IfcStructuralAnalysisDomain
IfcCableCarrierFittingTypeEnum	IfcElectricalDomain
IfcDoorStandardCase	IfcSharedBldgElements
IfcIndexedColourMap	IfcPresentationAppearanceResource
IfcEllipse	IfcGeometryResource
IfcOrientedEdge_List	Other
IfcOrganizationRelationship	IfcActorResource
IfcPlateStandardCase	IfcSharedBldgElements
IfcPositiveLengthMeasure	IfcMeasureResource
IfcStructuralLoadSingleDisplacement	IfcStructuralLoadResource
IfcTaskTime	IfcDateTimeResource
IfcCompressor	IfcHvacDomain
IfcCostSchedule	IfcSharedMgmtElements
IfcProcedure	IfcProcessExtension
IfcConstructionEquipmentResourceTypeEnum	IfcConstructionMgmtDomain
IfcLibraryReference	IfcExternalReferenceResource
IfcReal_List_List	Other
IfcWindowPanelProperties	IfcArchitectureDomain
IfcEvaporator	IfcHvacDomain
IfcIrregularTimeSeriesValue_EmptyList	Other
IfcGeometricRepresentationSubContext	IfcRepresentationResource
IfcShapeModel_List	Other
IfcActuatorTypeEnum	IfcBuildingControlsDomain
IfcAddressTypeEnum	IfcActorResource
IfcPersonAndOrganization	IfcActorResource
IfcFacetedBrep	IfcGeometricModelResource
IfcCsgSolid	IfcGeometricModelResource
IfcProtectiveDeviceType	IfcElectricalDomain
IfcUnitEnum	IfcMeasureResource
IfcTendonAnchorType	IfcStructuralElementsDomain
IfcSurfaceTexture	IfcPresentationAppearanceResource
IfcPermit	IfcSharedMgmtElements
IfcGridPlacement	IfcGeometricConstraintResource
IfcTimeOrRatioSelect	IfcDateTimeResource
IfcLoop	IfcTopologyResource
IfcSweptSurface	IfcGeometryResource
IfcPreDefinedCurveFont	IfcPresentationAppearanceResource
IfcLabel_EmptyList	Other
IfcAsset	IfcSharedFacilitiesElements
IfcPropertySetDefinition	IfcKernel
IfcDescriptiveMeasure	IfcMeasureResource
IfcReflectanceMethodEnum	IfcPresentationAppearanceResource
IfcRoofTypeEnum	IfcSharedBldgElements
IfcSurfaceStyle	IfcPresentationAppearanceResource
IfcMaterial	IfcMaterialResource
IfcArithmeticOperatorEnum	IfcCostResource
IfcTankType	IfcHvacDomain
IfcStructuralAction	IfcStructuralAnalysisDomain
IfcPumpType	IfcHvacDomain
IfcAxis2Placement3D	IfcGeometryResource
IfcCableSegmentTypeEnum	IfcElectricalDomain
IfcDoseEquivalentMeasure	IfcMeasureResource
IfcSoundPressureLevelMeasure	IfcMeasureResource
IfcDuctSegmentTypeEnum	IfcHvacDomain
IfcAudioVisualAppliance	IfcElectricalDomain
IfcDuctSilencerType	IfcHvacDomain
IfcMaterialLayerSet	IfcMaterialResource
IfcExternalReference	IfcExternalReferenceResource
IfcConstructionResource	IfcConstructionMgmtDomain
IfcSurfaceReinforcementArea	IfcStructuralLoadResource
IfcAirTerminalBox	IfcHvacDomain
IfcQuantityLength	IfcQuantityResource
IfcEnergyConversionDevice	IfcSharedBldgServiceElements
IfcRegularTimeSeries	IfcDateTimeResource
IfcDayInMonthNumber	IfcDateTimeResource
IfcLengthMeasure_List	Other
IfcMaterialProfile	IfcMaterialResource
IfcCartesianPoint_List_EmptyList	Other
IfcDimensionalExponents	IfcMeasureResource
IfcGeometricSet	IfcGeometricModelResource
IfcSpace	IfcProductExtension
IfcEnergyConversionDeviceType	IfcSharedBldgServiceElements
IfcBuildingElementPartTypeEnum	IfcSharedComponentElements
IfcUnitaryEquipmentType	IfcHvacDomain
IfcConstructionResourceType	IfcConstructionMgmtDomain
IfcAppliedValue	IfcCostResource
IfcCableSegmentType	IfcElectricalDomain
IfcTable	IfcUtilityResource
IfcCoolingTower	IfcHvacDomain
IfcBuildingElementPartType	IfcSharedComponentElements
IfcCompressorTypeEnum	IfcHvacDomain
IfcGridTypeEnum	IfcProductExtension
IfcBinary	IfcMeasureResource
IfcWorkSchedule	IfcProcessExtension
IfcPresentationStyleAssignment	IfcPresentationAppearanceResource
IfcOutletType	IfcElectricalDomain
IfcLightSource	IfcPresentationOrganizationResource
IfcCurveBoundedSurface	IfcGeometryResource
IfcSectionProperties	IfcProfileResource
IfcAxis2Placement2D	IfcGeometryResource
IfcSegmentIndexSelect	IfcGeometryResource
IfcDiscreteAccessoryTypeEnum	IfcSharedComponentElements
IfcColourRgbList	IfcPresentationAppearanceResource
IfcPropertySetDefinitionSet	IfcKernel
IfcLaborResourceType	IfcConstructionMgmtDomain
IfcDistributionPort	IfcSharedBldgServiceElements
IfcGridAxis	IfcGeometricConstraintResource
IfcObjectPlacement	IfcGeometricConstraintResource
IfcBoundaryNodeCondition	IfcStructuralLoadResource
IfcConstraint	IfcConstraintResource
IfcCommunicationsAppliance	IfcElectricalDomain
IfcSubContractResourceTypeEnum	IfcConstructionMgmtDomain
IfcDataOriginEnum	IfcDateTimeResource
IfcVector_List	Other
IfcElectricCapacitanceMeasure	IfcMeasureResource
IfcEngine	IfcHvacDomain
IfcLightDistributionData_EmptyList	Other
IfcApprovalRelationship	IfcApprovalResource
IfcCurveStyleFontSelect	IfcPresentationAppearanceResource
IfcCooledBeam	IfcHvacDomain
IfcBuildingElementProxyTypeEnum	IfcSharedBldgElements
IfcChangeActionEnum	IfcUtilityResource
IfcMaterialUsageDefinition	IfcMaterialResource
IfcParameterizedProfileDef	IfcProfileResource
IfcMaterialProfileSet	IfcMaterialResource
IfcWorkScheduleTypeEnum	IfcProcessExtension
IfcLightFixtureTypeEnum	IfcElectricalDomain
IfcMetricValueSelect	IfcConstraintResource
IfcPumpTypeEnum	IfcHvacDomain
IfcStructuralLoadGroup	IfcStructuralAnalysisDomain
IfcStructuralLoadConfiguration	IfcStructuralLoadResource
IfcDuctFittingType	IfcHvacDomain
IfcDocumentConfidentialityEnum	IfcExternalReferenceResource
IfcFlowDirectionEnum	IfcSharedBldgServiceElements
IfcCompositeCurveSegment_EmptyList	Other
IfcReinforcingBarRoleEnum	IfcProfileResource
IfcCircle	IfcGeometryResource
IfcModulusOfSubgradeReactionSelect	IfcStructuralLoadResource
IfcPresentationItem	IfcPresentationDefinitionResource
IfcAppliedValueSelect	IfcCostResource
IfcNormalisedRatioMeasure_List	Other
IfcTextPath	IfcPresentationDefinitionResource
IfcInventory	IfcSharedFacilitiesElements
IfcCoveringType	IfcSharedBldgElements
IfcElectricApplianceTypeEnum	IfcElectricalDomain
IfcLoadGroupTypeEnum	IfcStructuralAnalysisDomain
IfcFillAreaStyleHatching	IfcPresentationAppearanceResource
IfcMirroredProfileDef	IfcProfileResource
IfcDoorPanelOperationEnum	IfcArchitectureDomain
IfcComplexPropertyTemplateTypeEnum	IfcKernel
IfcColourOrFactor	IfcPresentationAppearanceResource
IfcBoundaryEdgeCondition	IfcStructuralLoadResource
IfcRelationship	IfcKernel
IfcLengthMeasure_List_List	Other
IfcPropertyEnumeratedValue	IfcPropertyResource
IfcStructuralCurveConnection	IfcStructuralAnalysisDomain
IfcDerivedUnitElement	IfcMeasureResource
IfcUnitaryEquipment	IfcHvacDomain
IfcInternalOrExternalEnum	IfcProductExtension
IfcConic	IfcGeometryResource
IfcEvaporatorTypeEnum	IfcHvacDomain
IfcColumnTypeEnum	IfcSharedBldgElements
IfcAxis2Placement	IfcGeometryResource
IfcObjectDefinition_EmptyList	Other
IfcOccupant	IfcSharedFacilitiesElements
IfcEvaporativeCooler	IfcHvacDomain
IfcWorkPlanTypeEnum	IfcProcessExtension
IfcStructuralPointAction	IfcStructuralAnalysisDomain
IfcFontWeight	IfcPresentationAppearanceResource
IfcQuantityWeight	IfcQuantityResource
IfcTransformer	IfcElectricalDomain
IfcTemperatureGradientMeasure	IfcMeasureResource
IfcObjectDefinition	IfcKernel
IfcBuildingSystem	IfcSharedBldgElements
IfcProductRepresentation	IfcRepresentationResource
IfcActor	IfcKernel
IfcColumn	IfcSharedBldgElements
IfcProfileDef	IfcProfileResource
IfcExternalSpatialStructureElement	IfcProductExtension
IfcCompositeCurveOnSurface	IfcGeometryResource
IfcComplexNumber	IfcMeasureResource
IfcLogical	IfcMeasureResource
IfcLuminousIntensityDistributionMeasure_EmptyList	Other
IfcZone	IfcProductExtension
IfcTendonType	IfcStructuralElementsDomain
IfcTableRow_List	Other
IfcTank	IfcHvacDomain
IfcConstructionProductResource	IfcConstructionMgmtDomain
IfcFastenerTypeEnum	IfcSharedComponentElements
IfcSpecularExponent	IfcPresentationAppearanceResource
IfcMaterialSelect	IfcMaterialResource
IfcBuildingElementProxyType	IfcSharedBldgElements
IfcConstraintEnum	IfcConstraintResource
IfcRelAssignsToGroup	IfcKernel
IfcRelAssociates	IfcKernel
IfcInteger_List	Other
IfcOpeningElementTypeEnum	IfcProductExtension
IfcWasteTerminal	IfcPlumbingFireProtectionDomain
IfcPerson	IfcActorResource
IfcSweptDiskSolid	IfcGeometricModelResource
IfcAnnotationFillArea	IfcPresentationDefinitionResource
IfcRevolvedAreaSolidTapered	IfcGeometricModelResource
IfcLagTime	IfcDateTimeResource
IfcMeasureWithUnit	IfcMeasureResource
IfcWarpingConstantMeasure	IfcMeasureResource
IfcShearModulusMeasure	IfcMeasureResource
IfcPipeSegmentTypeEnum	IfcHvacDomain
IfcCurveStyle	IfcPresentationAppearanceResource
IfcIonConcentrationMeasure	IfcMeasureResource
IfcBoundingBox	IfcGeometricModelResource
IfcBoundaryNodeConditionWarping	IfcStructuralLoadResource
IfcPressureMeasure	IfcMeasureResource
IfcLineIndex	IfcGeometryResource
IfcSlippageConnectionCondition	IfcStructuralLoadResource
IfcCartesianTransformationOperator2DnonUniform	IfcGeometryResource
IfcAnalysisModelTypeEnum	IfcStructuralAnalysisDomain
IfcBuildingElementProxy	IfcSharedBldgElements
IfcCartesianTransformationOperator	IfcGeometryResource
IfcLanguageId	IfcExternalReferenceResource
IfcRightCircularCylinder	IfcGeometricModelResource
IfcRelSequence	IfcProcessExtension
IfcActuatorType	IfcBuildingControlsDomain
IfcDuctFitting	IfcHvacDomain
IfcSegmentIndexSelect_List	Other
IfcHatchLineDistanceSelect	IfcPresentationAppearanceResource
IfcDistributionElement	IfcProductExtension
IfcSolidOrShell	IfcGeometricConstraintResource
IfcHumidifierType	IfcHvacDomain
IfcSectionalAreaIntegralMeasure	IfcMeasureResource
IfcCableSegment	IfcElectricalDomain
IfcIndexedPolygonalFace_List	Other
IfcMechanicalFastenerType	IfcSharedComponentElements
IfcChimney	IfcSharedBldgElements
IfcTrimmedCurve	IfcGeometryResource
IfcBuildingElement	IfcProductExtension
IfcCurveStyleFontPattern_List	Other
IfcStructuralSurfaceMember	IfcStructuralAnalysisDomain
IfcAxis1Placement	IfcGeometryResource
IfcPositiveInteger_EmptyList	Other
IfcMagneticFluxDensityMeasure	IfcMeasureResource
IfcSurfaceStyleRendering	IfcPresentationAppearanceResource
IfcParameterValue_List_EmptyList	Other
IfcAirTerminalType	IfcHvacDomain
IfcBSplineSurfaceForm	IfcGeometryResource
IfcSurfaceCurveSweptAreaSolid	IfcGeometricModelResource
IfcJunctionBoxTypeEnum	IfcElectricalDomain
IfcEventType	IfcProcessExtension
IfcUnitaryEquipmentTypeEnum	IfcHvacDomain
IfcSphericalSurface	IfcGeometryResource
IfcSphere	IfcGeometricModelResource
IfcBoundaryCurve	IfcGeometryResource
IfcCartesianPoint	IfcGeometryResource
IfcFastenerType	IfcSharedComponentElements
IfcRelDefinesByObject	IfcKernel
IfcTaskTypeEnum	IfcProcessExtension
IfcFace	IfcTopologyResource
IfcDoorStyleConstructionEnum	IfcArchitectureDomain
IfcAirToAirHeatRecoveryTypeEnum	IfcHvacDomain
IfcTime	IfcDateTimeResource
IfcBurnerType	IfcHvacDomain
IfcFrequencyMeasure	IfcMeasureResource
IfcActionTypeEnum	IfcStructuralAnalysisDomain
IfcRoundedRectangleProfileDef	IfcProfileResource
IfcTextFontName_EmptyList	Other
IfcExternallyDefinedSurfaceStyle	IfcPresentationAppearanceResource
IfcTableColumn	IfcUtilityResource
IfcCoveringTypeEnum	IfcSharedBldgElements
IfcSurface	IfcGeometryResource
IfcDocumentInformationRelationship	IfcExternalReferenceResource
IfcLightDistributionDataSourceSelect	IfcPresentationOrganizationResource
IfcTrimmingPreference	IfcGeometryResource
IfcPHMeasure	IfcMeasureResource
IfcObjectiveEnum	IfcConstraintResource
IfcSoundPowerLevelMeasure	IfcMeasureResource
IfcSimplePropertyTemplateTypeEnum	IfcKernel
IfcAddress	IfcActorResource
IfcCurveFontOrScaledCurveFontSelect	IfcPresentationAppearanceResource
IfcTextureCoordinateGenerator	IfcPresentationAppearanceResource
IfcPropertyTemplateDefinition	IfcKernel
IfcRightCircularCone	IfcGeometricModelResource
IfcCenterLineProfileDef	IfcProfileResource
IfcLightDistributionData	IfcPresentationOrganizationResource
IfcKinematicViscosityMeasure	IfcMeasureResource
IfcShadingDeviceType	IfcSharedBldgElements
IfcConstraint_EmptyList	Other
IfcEllipseProfileDef	IfcProfileResource
IfcRelSpaceBoundary1stLevel	IfcProductExtension
IfcBoilerType	IfcHvacDomain
IfcExternalInformation	IfcExternalReferenceResource
IfcInteger	IfcMeasureResource
IfcObjectReferenceSelect	IfcPropertyResource
IfcRelAssigns	IfcKernel
IfcAppliedValue_EmptyList	Other
IfcLuminousFluxMeasure	IfcMeasureResource
IfcFilter	IfcHvacDomain
IfcVirtualGridIntersection	IfcGeometricConstraintResource
IfcRelConnectsPorts	IfcProductExtension
IfcRelConnectsStructuralMember	IfcStructuralAnalysisDomain
IfcConstraint_List	Other
IfcWindowLiningProperties	IfcArchitectureDomain
IfcMotorConnectionType	IfcElectricalDomain
IfcHeatingValueMeasure	IfcMeasureResource
IfcGridPlacementDirectionSelect	IfcGeometricConstraintResource
IfcURIReference_List	Other
IfcWindowPanelPositionEnum	IfcArchitectureDomain
IfcDocumentStatusEnum	IfcExternalReferenceResource
IfcObject	IfcKernel
IfcTendonAnchor	IfcStructuralElementsDomain
IfcPileConstructionEnum	IfcStructuralElementsDomain
IfcHumidifierTypeEnum	IfcHvacDomain
IfcStructuralLoadOrResult_List	Other
IfcDamper	IfcHvacDomain
IfcCurve	IfcGeometryResource
IfcDistributionElementType	IfcProductExtension
IfcBoxedHalfSpace	IfcGeometricModelResource
IfcColumnStandardCase	IfcSharedBldgElements
IfcCountMeasure	IfcMeasureResource
IfcTemperatureRateOfChangeMeasure	IfcMeasureResource
IfcRectangularPyramid	IfcGeometricModelResource
IfcPositiveInteger	IfcMeasureResource
IfcPermeableCoveringProperties	IfcArchitectureDomain
IfcDuration	IfcDateTimeResource
IfcFlowTreatmentDeviceType	IfcSharedBldgServiceElements
IfcFan	IfcHvacDomain
IfcTextStyleForDefinedFont	IfcPresentationAppearanceResource
IfcConstructionEquipmentResourceType	IfcConstructionMgmtDomain
IfcBlobTexture	IfcPresentationAppearanceResource
IfcCoilType	IfcHvacDomain
IfcSensorTypeEnum	IfcBuildingControlsDomain
IfcCurveStyleFont	IfcPresentationAppearanceResource
IfcClassificationReference	IfcExternalReferenceResource
IfcShapeRepresentation	IfcRepresentationResource
IfcReinforcingBarSurfaceEnum	IfcProfileResource
IfcTextFontName_List	Other
IfcCrewResource	IfcConstructionMgmtDomain
IfcStructuralConnectionCondition	IfcStructuralLoadResource
IfcRecurrenceTypeEnum	IfcDateTimeResource
IfcStructuralCurveReaction	IfcStructuralAnalysisDomain
IfcFlowMovingDeviceType	IfcSharedBldgServiceElements
IfcTransportElementType	IfcProductExtension
IfcElectricGenerator	IfcElectricalDomain
IfcCoil	IfcHvacDomain
IfcSIPrefix	IfcMeasureResource
IfcWarpingStiffnessSelect	IfcStructuralLoadResource
IfcIsothermalMoistureCapacityMeasure	IfcMeasureResource
IfcRamp	IfcSharedBldgElements
IfcRelAssociatesDocument	IfcKernel
IfcWasteTerminalType	IfcPlumbingFireProtectionDomain
IfcCartesianTransformationOperator2D	IfcGeometryResource
IfcElectricAppliance	IfcElectricalDomain
IfcMaterialProperties	IfcMaterialResource
IfcVertexLoop	IfcTopologyResource
IfcSystemFurnitureElement	IfcSharedFacilitiesElements
IfcStructuralLoadCase	IfcStructuralAnalysisDomain
IfcPlateType	IfcSharedBldgElements
IfcSweptDiskSolidPolygonal	IfcGeometricModelResource
IfcFaceBasedSurfaceModel	IfcGeometricModelResource
IfcWorkPlan	IfcProcessExtension
IfcClosedShell	IfcTopologyResource
IfcMechanicalFastener	IfcSharedComponentElements
IfcWindow	IfcSharedBldgElements
IfcTelecomAddress	IfcActorResource
IfcConnectionPointGeometry	IfcGeometricConstraintResource
IfcMolecularWeightMeasure	IfcMeasureResource
IfcConstructionProductResourceType	IfcConstructionMgmtDomain
IfcOffsetCurve3D	IfcGeometryResource
IfcValve	IfcHvacDomain
IfcDocumentReference	IfcExternalReferenceResource
IfcCivilElementType	IfcProductExtension
IfcBooleanOperator	IfcGeometricModelResource
IfcSolidModel	IfcGeometricModelResource
IfcCivilElement	IfcProductExtension
IfcShapeModel_EmptyList	Other
IfcLayeredItem	IfcPresentationOrganizationResource
IfcDoorType	IfcSharedBldgElements
IfcSpatialStructureElementType	IfcProductExtension
IfcElementType	IfcProductExtension
IfcMaterialLayer_List	Other
IfcPropertyEnumeration	IfcPropertyResource
IfcPixelTexture	IfcPresentationAppearanceResource
IfcProperty	IfcPropertyResource
IfcTransitionCode	IfcGeometryResource
IfcBSplineSurface	IfcGeometryResource
IfcProcedureTypeEnum	IfcProcessExtension
IfcPostalAddress	IfcActorResource
IfcRectangularTrimmedSurface	IfcGeometryResource
IfcStructuralLoadStatic	IfcStructuralLoadResource
IfcDuctFittingTypeEnum	IfcHvacDomain
IfcSimpleProperty	IfcPropertyResource
IfcNormalisedRatioMeasure	IfcMeasureResource
IfcCrewResourceTypeEnum	IfcConstructionMgmtDomain
IfcDate	IfcDateTimeResource
IfcFurnishingElement	IfcProductExtension
IfcURIReference_EmptyList	Other
IfcStyleAssignmentSelect	IfcPresentationAppearanceResource
IfcLinearStiffnessMeasure	IfcMeasureResource
IfcStructuralSurfaceMemberTypeEnum	IfcStructuralAnalysisDomain
IfcStructuralLoadSingleForceWarping	IfcStructuralLoadResource
IfcEdgeCurve	IfcTopologyResource
IfcStructuralPlanarAction	IfcStructuralAnalysisDomain
IfcHalfSpaceSolid	IfcGeometricModelResource
IfcLengthMeasure	IfcMeasureResource
IfcParameterValue_List_List	Other
IfcPcurve_EmptyList	Other
IfcLine	IfcGeometryResource
IfcStructuralLoadSingleForce	IfcStructuralLoadResource
IfcVector_EmptyList	Other
IfcDerivedProfileDef	IfcProfileResource
IfcSwitchingDeviceTypeEnum	IfcElectricalDomain
IfcMaterialProfileSetUsage	IfcMaterialResource
IfcSensorType	IfcBuildingControlsDomain
IfcChiller	IfcHvacDomain
IfcRelConnectsPortToElement	IfcProductExtension
IfcBooleanOperand	IfcGeometricModelResource
IfcHeatFluxDensityMeasure	IfcMeasureResource
IfcTimeSeriesValue	IfcDateTimeResource
IfcOuterBoundaryCurve	IfcGeometryResource
IfcFlowSegmentType	IfcSharedBldgServiceElements
IfcRelNests	IfcKernel
IfcExtrudedAreaSolidTapered	IfcGeometricModelResource
IfcBSplineCurve	IfcGeometryResource
IfcSpaceType	IfcProductExtension
IfcLibraryInformation	IfcExternalReferenceResource
IfcDraughtingPreDefinedCurveFont	IfcPresentationAppearanceResource
IfcSoundPowerMeasure	IfcMeasureResource
IfcReinforcementBarProperties	IfcProfileResource
IfcFurniture	IfcSharedFacilitiesElements
IfcWorkTime	IfcDateTimeResource
IfcLightDistributionCurveEnum	IfcPresentationOrganizationResource
IfcElectricCurrentMeasure	IfcMeasureResource
IfcSwitchingDevice	IfcElectricalDomain
IfcDistributionChamberElementTypeEnum	IfcSharedBldgServiceElements
IfcRepresentationMap_List	Other
IfcControllerType	IfcBuildingControlsDomain
IfcReinforcingElement	IfcStructuralElementsDomain
IfcLightDistributionData_List	Other
IfcTransformerType	IfcElectricalDomain
IfcBSplineCurveWithKnots	IfcGeometryResource
IfcWallElementedCase	IfcSharedBldgElements
IfcSite	IfcProductExtension
IfcMappedItem	IfcGeometryResource
IfcFacetedBrepWithVoids	IfcGeometricModelResource
IfcBSplineSurfaceWithKnots	IfcGeometryResource
IfcConstructionMaterialResourceType	IfcConstructionMgmtDomain
IfcStructuralSurfaceAction	IfcStructuralAnalysisDomain
IfcStructuralAnalysisModel	IfcStructuralAnalysisDomain
IfcGeometricRepresentationContext	IfcRepresentationResource
IfcResourceTime	IfcDateTimeResource
IfcStructuralCurveMemberTypeEnum	IfcStructuralAnalysisDomain
IfcBuildingSystemTypeEnum	IfcSharedBldgElements
IfcRelSpaceBoundary2ndLevel	IfcProductExtension
IfcArbitraryProfileDefWithVoids	IfcProfileResource
IfcLogicalOperatorEnum	IfcConstraintResource
IfcManifoldSolidBrep	IfcGeometricModelResource
IfcProtectiveDeviceTrippingUnitTypeEnum	IfcElectricalDomain
IfcRepresentation_List	Other
IfcUnitaryControlElementTypeEnum	IfcBuildingControlsDomain
IfcTShapeProfileDef	IfcProfileResource
IfcCurveStyleFontAndScaling	IfcPresentationAppearanceResource
IfcVibrationIsolatorTypeEnum	IfcHvacDomain
IfcProject	IfcKernel
IfcPolyLoop	IfcTopologyResource
IfcSectionModulusMeasure	IfcMeasureResource
IfcAirTerminal	IfcHvacDomain
IfcAdvancedBrepWithVoids	IfcGeometricModelResource
IfcSolidAngleMeasure	IfcMeasureResource
IfcRoot	IfcKernel
IfcRationalBSplineCurveWithKnots	IfcGeometryResource
IfcProtectiveDeviceTrippingUnit	IfcElectricalDomain
IfcAdvancedBrep	IfcGeometricModelResource
IfcSurfaceOfLinearExtrusion	IfcGeometryResource
IfcQuantityVolume	IfcQuantityResource
IfcVoidingFeature	IfcStructuralElementsDomain
IfcCondenser	IfcHvacDomain
IfcPresentationStyleSelect	IfcPresentationAppearanceResource
IfcCoolingTowerType	IfcHvacDomain
IfcElementarySurface	IfcGeometryResource
IfcSubedge	IfcTopologyResource
IfcWindowTypeEnum	IfcSharedBldgElements
IfcPowerMeasure	IfcMeasureResource
IfcBeamType	IfcSharedBldgElements
IfcAssemblyPlaceEnum	IfcProductExtension
IfcWindowStyle	IfcArchitectureDomain
IfcMaterialRelationship	IfcMaterialResource
IfcMedicalDeviceType	IfcHvacDomain
IfcSurfaceTexture_List	Other
IfcElectricMotorType	IfcElectricalDomain
IfcSystem	IfcProductExtension
IfcLightFixture	IfcElectricalDomain
IfcBurner	IfcHvacDomain
IfcSurfaceTexture_EmptyList	Other
IfcRotationalFrequencyMeasure	IfcMeasureResource
IfcCsgPrimitive3D	IfcGeometricModelResource
IfcSanitaryTerminalType	IfcPlumbingFireProtectionDomain
IfcIdentifier_List	Other
IfcAreaDensityMeasure	IfcMeasureResource
IfcReal_List	Other
IfcTextureMap	IfcPresentationAppearanceResource
IfcTextFontSelect	IfcPresentationAppearanceResource
IfcPropertySetTemplateTypeEnum	IfcKernel
IfcCondenserType	IfcHvacDomain
IfcPolyline	IfcGeometryResource
IfcFlowStorageDeviceType	IfcSharedBldgServiceElements
IfcActionSourceTypeEnum	IfcStructuralAnalysisDomain
IfcRoofType	IfcSharedBldgElements
IfcExternalSpatialElementTypeEnum	IfcProductExtension
IfcShadingDeviceTypeEnum	IfcSharedBldgElements
IfcTypeProcess	IfcKernel
IfcConnectedFaceSet	IfcTopologyResource
IfcStructuralSurfaceReaction	IfcStructuralAnalysisDomain
IfcSlabTypeEnum	IfcSharedBldgElements
IfcTrimmingSelect	IfcGeometryResource
IfcRelAssociatesClassification	IfcKernel
IfcPositiveInteger_List_EmptyList	Other
IfcCableCarrierSegment	IfcElectricalDomain
IfcComplexPropertyTemplate	IfcKernel
IfcFlowSegment	IfcSharedBldgServiceElements
IfcPile	IfcStructuralElementsDomain
IfcDoorPanelProperties	IfcArchitectureDomain
IfcParameterValue	IfcMeasureResource
IfcPermitTypeEnum	IfcSharedMgmtElements
IfcEngineTypeEnum	IfcHvacDomain
IfcElementQuantity	IfcProductExtension
IfcObjectDefinition_List	Other
IfcActorRole_List	Other
IfcBoundaryFaceCondition	IfcStructuralLoadResource
IfcExtrudedAreaSolid	IfcGeometricModelResource
IfcLocalPlacement	IfcGeometricConstraintResource
IfcPolygonalBoundedHalfSpace	IfcGeometricModelResource
IfcSolarDevice	IfcElectricalDomain
IfcParameterValue_EmptyList	Other
IfcPerformanceHistory	IfcControlExtension
IfcOutlet	IfcElectricalDomain
IfcStructuralCurveActivityTypeEnum	IfcStructuralAnalysisDomain
IfcPipeSegment	IfcHvacDomain
IfcMagneticFluxMeasure	IfcMeasureResource
IfcCurtainWallTypeEnum	IfcSharedBldgElements
IfcIdentifier_EmptyList	Other
IfcMaterial_List	Other
IfcRelConnectsStructuralActivity	IfcStructuralAnalysisDomain
IfcSwitchingDeviceType	IfcElectricalDomain
IfcPreDefinedProperties	IfcPropertyResource
IfcStairTypeEnum	IfcSharedBldgElements
IfcReinforcementDefinitionProperties	IfcStructuralElementsDomain
IfcRelConnectsWithEccentricity	IfcStructuralAnalysisDomain
IfcElementCompositionEnum	IfcProductExtension
IfcResourceLevelRelationship	IfcExternalReferenceResource
IfcFanTypeEnum	IfcHvacDomain
IfcPresentationLayerAssignment	IfcPresentationOrganizationResource
IfcElectricFlowStorageDevice	IfcElectricalDomain
IfcSensor	IfcBuildingControlsDomain
IfcProjectedCRS	IfcRepresentationResource
IfcIndexedPolygonalFace_EmptyList	Other
IfcFixedReferenceSweptAreaSolid	IfcGeometricModelResource
IfcMassDensityMeasure	IfcMeasureResource
IfcPcurve_List	Other
IfcSectionTypeEnum	IfcProfileResource
IfcRecurrencePattern	IfcDateTimeResource
IfcRelReferencedInSpatialStructure	IfcProductExtension
IfcStructuralPointConnection	IfcStructuralAnalysisDomain
IfcRevolvedAreaSolid	IfcGeometricModelResource
IfcWorkControl	IfcProcessExtension
IfcTankTypeEnum	IfcHvacDomain
IfcRelAssignsToProcess	IfcKernel
IfcCurveBoundedPlane	IfcGeometryResource
IfcInventoryTypeEnum	IfcSharedFacilitiesElements
IfcUnit	IfcMeasureResource
IfcFlowMeter	IfcHvacDomain
IfcSurfaceSide	IfcPresentationAppearanceResource
IfcPcurve	IfcGeometryResource
IfcMaterialClassificationRelationship	IfcMaterialResource
IfcWindowType	IfcSharedBldgElements
IfcEvaporativeCoolerType	IfcHvacDomain
IfcTendonAnchorTypeEnum	IfcStructuralElementsDomain
IfcFurnitureTypeEnum	IfcSharedFacilitiesElements
IfcPropertySetDefinitionSelect	IfcKernel
IfcFillAreaStyleTiles	IfcPresentationAppearanceResource
IfcQuantityCount	IfcQuantityResource
IfcToroidalSurface	IfcGeometryResource
IfcElementComponentType	IfcSharedComponentElements
IfcPhysicalComplexQuantity	IfcQuantityResource
IfcGeographicElementTypeEnum	IfcProductExtension
IfcStructuralLinearAction	IfcStructuralAnalysisDomain
IfcBeamTypeEnum	IfcSharedBldgElements
IfcTextStyleTextModel	IfcPresentationAppearanceResource
IfcFlowMeterTypeEnum	IfcHvacDomain
IfcPointOnCurve	IfcGeometryResource
IfcDistributionFlowElement	IfcSharedBldgServiceElements
IfcShadingDevice	IfcSharedBldgElements
IfcObjective	IfcConstraintResource
IfcPositiveInteger_List_List	Other
IfcFlowTreatmentDevice	IfcSharedBldgServiceElements
IfcRelAssociatesMaterial	IfcProductExtension
IfcContextDependentUnit	IfcMeasureResource
IfcGeometricProjectionEnum	IfcRepresentationResource
IfcSpatialZone	IfcProductExtension
IfcElectricApplianceType	IfcElectricalDomain
IfcWallTypeEnum	IfcSharedBldgElements
IfcRampTypeEnum	IfcSharedBldgElements
IfcDateTime	IfcDateTimeResource
IfcMassPerLengthMeasure	IfcMeasureResource
IfcTendonTypeEnum	IfcStructuralElementsDomain
IfcUShapeProfileDef	IfcProfileResource
IfcHeatExchanger	IfcHvacDomain
IfcOwnerHistory	IfcUtilityResource
IfcCrewResourceType	IfcConstructionMgmtDomain
IfcCableFitting	IfcElectricalDomain
IfcDistributionChamberElementType	IfcSharedBldgServiceElements
IfcReal_List_EmptyList	Other
IfcProjectLibrary	IfcKernel
IfcRepresentationMap_EmptyList	Other
IfcDoorTypeEnum	IfcSharedBldgElements
IfcMemberType	IfcSharedBldgElements
IfcMaterialDefinitionRepresentation	IfcRepresentationResource
IfcURIReference	IfcExternalReferenceResource
IfcRailing	IfcSharedBldgElements
IfcFillAreaStyle	IfcPresentationAppearanceResource
IfcVertex	IfcTopologyResource
IfcSchedulingTime	IfcDateTimeResource
IfcInductanceMeasure	IfcMeasureResource
IfcModulusOfLinearSubgradeReactionMeasure	IfcMeasureResource
IfcPort	IfcProductExtension
IfcProjectionElement	IfcProductExtension
IfcFilterType	IfcHvacDomain
IfcFooting	IfcStructuralElementsDomain
IfcActionRequestTypeEnum	IfcSharedMgmtElements
IfcCoordinateReferenceSystemSelect	IfcRepresentationResource
IfcPropertySetTemplate	IfcKernel
IfcRatioMeasure	IfcMeasureResource
IfcPhysicalQuantity_List	Other
IfcGeometricSetSelect	IfcGeometricModelResource
IfcIlluminanceMeasure	IfcMeasureResource
IfcOccupantTypeEnum	IfcSharedFacilitiesElements
IfcSizeSelect	IfcPresentationAppearanceResource
IfcAlarmType	IfcBuildingControlsDomain
IfcDerivedMeasureValue	IfcMeasureResource
IfcAnnotation	IfcProductExtension
IfcTimeSeriesValue_EmptyList	Other
IfcPreDefinedItem	IfcPresentationAppearanceResource
IfcVaporPermeabilityMeasure	IfcMeasureResource
IfcMassFlowRateMeasure	IfcMeasureResource
IfcPath	IfcTopologyResource
IfcAudioVisualApplianceTypeEnum	IfcElectricalDomain
IfcSectionReinforcementProperties_EmptyList	Other
IfcRelAssociatesConstraint	IfcControlExtension
IfcWindowStyleOperationEnum	IfcArchitectureDomain
IfcBeam	IfcSharedBldgElements
IfcExternalReferenceRelationship	IfcExternalReferenceResource
IfcElectricMotor	IfcElectricalDomain
IfcOpenShell	IfcTopologyResource
IfcRelAssignsToControl	IfcKernel
IfcApplication	IfcUtilityResource
IfcGeometricCurveSet	IfcGeometricModelResource
IfcSpaceTypeEnum	IfcProductExtension
IfcTopologyRepresentation	IfcRepresentationResource
IfcObjectTypeEnum	IfcKernel
IfcPresentationStyle	IfcPresentationAppearanceResource
IfcSpaceHeaterType	IfcHvacDomain
IfcQuantityArea	IfcQuantityResource
IfcBuildingElementType	IfcProductExtension
IfcElectricFlowStorageDeviceType	IfcElectricalDomain
IfcIShapeProfileDef	IfcProfileResource
IfcBuildingStorey	IfcProductExtension
IfcDerivedUnit	IfcMeasureResource
IfcGridAxis_List	Other
IfcAlarmTypeEnum	IfcBuildingControlsDomain
IfcSubContractResource	IfcConstructionMgmtDomain
IfcCompositeCurve	IfcGeometryResource
IfcValveType	IfcHvacDomain
IfcTableColumn_EmptyList	Other
IfcMaterialProfileSetUsageTapering	IfcMaterialResource
IfcLightSourceDirectional	IfcPresentationOrganizationResource
IfcEdgeLoop	IfcTopologyResource
IfcWarpingMomentMeasure	IfcMeasureResource
IfcBoiler	IfcHvacDomain
IfcRelDefinesByType	IfcKernel
IfcSIUnitName	IfcMeasureResource
IfcVertexPoint	IfcTopologyResource
IfcDoorStyleOperationEnum	IfcArchitectureDomain
IfcFontVariant	IfcPresentationAppearanceResource
IfcUnitaryControlElement	IfcBuildingControlsDomain
IfcDistributionChamberElement	IfcSharedBldgServiceElements
IfcBurnerTypeEnum	IfcHvacDomain
IfcAdvancedFace	IfcTopologyResource
IfcCableCarrierFittingType	IfcElectricalDomain
IfcProfileDef_List	Other
IfcFootingTypeEnum	IfcStructuralElementsDomain
IfcActorRole	IfcActorResource
IfcCoolingTowerTypeEnum	IfcHvacDomain
IfcCircleHollowProfileDef	IfcProfileResource
IfcTriangulatedFaceSet	IfcGeometricModelResource
IfcPlate	IfcSharedBldgElements
IfcArbitraryClosedProfileDef	IfcProfileResource
IfcCurveInterpolationEnum	IfcPropertyResource
IfcSpaceHeater	IfcHvacDomain
IfcTimeSeriesDataTypeEnum	IfcDateTimeResource
IfcRelAggregates	IfcKernel
IfcRelCoversSpaces	IfcSharedBldgElements
IfcElectricFlowStorageDeviceTypeEnum	IfcElectricalDomain
IfcTaskDurationEnum	IfcDateTimeResource
IfcGrid	IfcProductExtension
IfcModulusOfRotationalSubgradeReactionSelect	IfcStructuralLoadResource
IfcValue	IfcMeasureResource
IfcSolarDeviceTypeEnum	IfcElectricalDomain
IfcMetric	IfcConstraintResource
IfcModulusOfElasticityMeasure	IfcMeasureResource
IfcRelDefinesByTemplate	IfcKernel
IfcVectorOrDirection	IfcGeometryResource
IfcEdge	IfcTopologyResource
IfcAmountOfSubstanceMeasure	IfcMeasureResource
IfcVector	IfcGeometryResource
IfcDoorTypeOperationEnum	IfcSharedBldgElements
IfcLibrarySelect	IfcExternalReferenceResource
IfcShellBasedSurfaceModel	IfcGeometricModelResource
IfcTaskType	IfcProcessExtension
IfcValue_List	Other
IfcPipeSegmentType	IfcHvacDomain
IfcTorqueMeasure	IfcMeasureResource
IfcWorkCalendarTypeEnum	IfcProcessExtension
IfcFilterTypeEnum	IfcHvacDomain
IfcRoof	IfcSharedBldgElements
IfcDistributionSystem	IfcSharedBldgServiceElements
IfcPlateTypeEnum	IfcSharedBldgElements
IfcLightSourcePositional	IfcPresentationOrganizationResource
IfcSpaceHeaterTypeEnum	IfcHvacDomain
IfcChimneyType	IfcSharedBldgElements
IfcElectricResistanceMeasure	IfcMeasureResource
IfcBendingParameterSelect	IfcStructuralElementsDomain
IfcRationalBSplineSurfaceWithKnots	IfcGeometryResource
IfcMonthInYearNumber	IfcDateTimeResource
IfcElectricDistributionBoard	IfcElectricalDomain
IfcMoistureDiffusivityMeasure	IfcMeasureResource
IfcConstructionMaterialResourceTypeEnum	IfcConstructionMgmtDomain
IfcStructuralSurfaceConnection	IfcStructuralAnalysisDomain
IfcLamp	IfcElectricalDomain
IfcIndexedTextureMap	IfcPresentationAppearanceResource
IfcReference	IfcConstraintResource
