IfcTubeBundleType	Entities
IfcDiscreteAccessory	Entities
IfcShell	Types
IfcIndexedPolygonalFace	Entities
IfcPlanarBox	Entities
IfcCurveStyleFontPattern	Entities
IfcMotorConnectionTypeEnum	Types
IfcLuminousIntensityMeasure	Types
IfcSpatialElement	Entities
IfcThermalTransmittanceMeasure	Types
IfcFaceOuterBound	Entities
IfcGeographicElementType	Entities
IfcNamedUnit	Entities
IfcCurveOrEdgeCurve	Types
IfcRelCoversBldgElements	Entities
IfcLabel	Types
IfcLayerSetDirectionEnum	Types
IfcText	Types
IfcCompoundPlaneAngleMeasure	Types
IfcAbsorbedDoseMeasure	Types
IfcStructuralLoad	Entities
IfcPlaneAngleMeasure_List	Other
IfcFlowInstrumentType	Entities
IfcDamperTypeEnum	Types
IfcLaborResourceTypeEnum	Types
IfcAccelerationMeasure	Types
IfcSweptAreaSolid	Entities
IfcSpaceBoundarySelect	Types
IfcPropertyAbstraction	Entities
IfcCoordinateReferenceSystem	Entities
IfcLampType	Entities
IfcCartesianTransformationOperator3DnonUniform	Entities
IfcRelDefines	Entities
IfcEvent	Entities
IfcModulusOfSubgradeReactionMeasure	Types
IfcLightIntensityDistribution	Entities
IfcReal	Types
IfcPlanarForceMeasure	Types
IfcConversionBasedUnitWithOffset	Entities
IfcPileType	Entities
IfcPermeableCoveringOperationEnum	Types
IfcRelServicesBuildings	Entities
IfcElectricTimeControlTypeEnum	Types
IfcReinforcingBarType	Entities
IfcDoorPanelPositionEnum	Types
IfcFanType	Entities
IfcLabel_List	Other
IfcFeatureElementAddition	Entities
IfcProcess	Entities
IfcWorkCalendar	Entities
IfcStairFlightTypeEnum	Types
IfcPropertyReferenceValue	Entities
IfcAirTerminalBoxType	Entities
IfcAirToAirHeatRecoveryType	Entities
IfcTransportElement	Entities
IfcCShapeProfileDef	Entities
IfcCompressorType	Entities
IfcSoundPressureMeasure	Types
IfcStructuralCurveAction	Entities
IfcStructuralItem	Entities
IfcBoolean	Types
IfcProductDefinitionShape	Entities
IfcStateEnum	Types
IfcCartesianPointList3D	Entities
IfcLampTypeEnum	Types
IfcNormalisedRatioMeasure_EmptyList	Other
IfcIntegerCountRateMeasure	Types
IfcPreDefinedPropertySet	Entities
IfcTableRow_EmptyList	Other
IfcThermalConductivityMeasure	Types
IfcTimePeriod_EmptyList	Other
IfcProfileTypeEnum	Types
IfcFireSuppressionTerminalTypeEnum	Types
IfcCostValue_List	Other
IfcLengthMeasure_EmptyList	Other
IfcDistributionPortTypeEnum	Types
IfcHeatExchangerTypeEnum	Types
IfcReinforcingBar	Entities
IfcPreferredSurfaceCurveRepresentation	Types
IfcStructuralLoadSingleDisplacementDistortion	Entities
IfcRelAssignsToProduct	Entities
IfcCompositeCurveSegment	Entities
IfcTimeSeriesValue_List	Other
IfcBuildingElementPart	Entities
IfcTendon	Entities
IfcTimeSeries	Entities
IfcStyledRepresentation	Entities
IfcFlowTerminalType	Entities
IfcProtectiveDevice	Entities
IfcTransportElementTypeEnum	Types
IfcRatioMeasure_List	Other
IfcDuctSilencer	Entities
IfcCoilTypeEnum	Types
IfcPointOrVertexPoint	Types
IfcExternallyDefinedTextFont	Entities
IfcDimensionCount	Types
IfcPropertyDefinition	Entities
IfcTextureVertexList	Entities
IfcParameterValue_List	Other
IfcCircleProfileDef	Entities
IfcContext	Entities
IfcGeometricRepresentationItem	Entities
IfcFailureConnectionCondition	Entities
IfcSIUnit	Entities
IfcThermalExpansionCoefficientMeasure	Types
IfcTextureCoordinate	Entities
IfcInterceptor	Entities
IfcRelAssociatesLibrary	Entities
IfcFastener	Entities
IfcProtectiveDeviceTypeEnum	Types
IfcCableCarrierSegmentTypeEnum	Types
IfcConnectionCurveGeometry	Entities
IfcSurfaceStyleShading	Entities
IfcCartesianPoint_EmptyList	Other
IfcSurfaceStyleElementSelect	Types
IfcStructuralLoadPlanarForce	Entities
IfcCableCarrierFitting	Entities
IfcRampFlight	Entities
IfcCableFittingType	Entities
IfcKnotType	Types
IfcFlowMovingDevice	Entities
IfcDoorLiningProperties	Entities
IfcComplexProperty	Entities
IfcLShapeProfileDef	Entities
IfcCommunicationsApplianceTypeEnum	Types
IfcSpecularRoughness	Types
IfcPlane	Entities
IfcProductRepresentationSelect	Types
IfcFeatureElementSubtraction	Entities
IfcBoundaryCondition	Entities
IfcRectangleHollowProfileDef	Entities
IfcShapeModel	Entities
IfcThermalResistanceMeasure	Types
IfcSectionedSpine	Entities
IfcIndexedTriangleTextureMap	Entities
IfcCableCarrierSegmentType	Entities
IfcLightSourceSpot	Entities
IfcBoilerTypeEnum	Types
IfcUnitaryControlElementType	Entities
IfcBooleanClippingResult	Entities
IfcFontStyle	Types
IfcChillerType	Entities
IfcTranslationalStiffnessSelect	Types
IfcPhysicalQuantity_EmptyList	Other
IfcRampFlightTypeEnum	Types
IfcPhysicalOrVirtualEnum	Types
IfcTextDecoration	Types
IfcMassMeasure	Types
IfcDocumentSelect	Types
IfcBooleanResult	Entities
IfcBenchmarkEnum	Types
IfcCurveStyleFontPattern_EmptyList	Other
IfcTubeBundle	Entities
IfcMaterialLayer	Entities
IfcPlaneAngleMeasure	Types
IfcFlowInstrumentTypeEnum	Types
IfcFurnitureType	Entities
IfcMomentOfInertiaMeasure	Types
IfcCsgSelect	Types
IfcCovering	Entities
IfcTypeObject	Entities
IfcZShapeProfileDef	Entities
IfcStairFlightType	Entities
IfcFlowControllerType	Entities
IfcTableColumn_List	Other
IfcSurfaceStyleLighting	Entities
IfcDirectionSenseEnum	Types
IfcSanitaryTerminalTypeEnum	Types
IfcGroup	Entities
IfcAnalysisTheoryTypeEnum	Types
IfcLightSourceAmbient	Entities
IfcResourceObjectSelect	Types
IfcStructuralSurfaceMemberVarying	Entities
IfcCableCarrierFittingTypeEnum	Types
IfcDoorStandardCase	Entities
IfcIndexedColourMap	Entities
IfcEllipse	Entities
IfcOrientedEdge_List	Other
IfcOrganizationRelationship	Entities
IfcPlateStandardCase	Entities
IfcPositiveLengthMeasure	Types
IfcStructuralLoadSingleDisplacement	Entities
IfcTaskTime	Entities
IfcCompressor	Entities
IfcCostSchedule	Entities
IfcProcedure	Entities
IfcConstructionEquipmentResourceTypeEnum	Types
IfcLibraryReference	Entities
IfcReal_List_List	Other
IfcWindowPanelProperties	Entities
IfcEvaporator	Entities
IfcIrregularTimeSeriesValue_EmptyList	Other
IfcGeometricRepresentationSubContext	Entities
IfcShapeModel_List	Other
IfcActuatorTypeEnum	Types
IfcAddressTypeEnum	Types
IfcPersonAndOrganization	Entities
IfcFacetedBrep	Entities
IfcCsgSolid	Entities
IfcProtectiveDeviceType	Entities
IfcUnitEnum	Types
IfcTendonAnchorType	Entities
IfcSurfaceTexture	Entities
IfcPermit	Entities
IfcGridPlacement	Entities
IfcTimeOrRatioSelect	Types
IfcLoop	Entities
IfcSweptSurface	Entities
IfcPreDefinedCurveFont	Entities
IfcLabel_EmptyList	Other
IfcAsset	Entities
IfcPropertySetDefinition	Entities
IfcDescriptiveMeasure	Types
IfcReflectanceMethodEnum	Types
IfcRoofTypeEnum	Types
IfcSurfaceStyle	Entities
IfcMaterial	Entities
IfcArithmeticOperatorEnum	Types
IfcTankType	Entities
IfcStructuralAction	Entities
IfcPumpType	Entities
IfcAxis2Placement3D	Entities
IfcCableSegmentTypeEnum	Types
IfcDoseEquivalentMeasure	Types
IfcSoundPressureLevelMeasure	Types
IfcDuctSegmentTypeEnum	Types
IfcAudioVisualAppliance	Entities
IfcDuctSilencerType	Entities
IfcMaterialLayerSet	Entities
IfcExternalReference	Entities
IfcConstructionResource	Entities
IfcSurfaceReinforcementArea	Entities
IfcAirTerminalBox	Entities
IfcQuantityLength	Entities
IfcEnergyConversionDevice	Entities
IfcRegularTimeSeries	Entities
IfcDayInMonthNumber	Types
IfcLengthMeasure_List	Other
IfcMaterialProfile	Entities
IfcCartesianPoint_List_EmptyList	Other
IfcDimensionalExponents	Entities
IfcGeometricSet	Entities
IfcSpace	Entities
IfcEnergyConversionDeviceType	Entities
IfcBuildingElementPartTypeEnum	Types
IfcUnitaryEquipmentType	Entities
IfcConstructionResourceType	Entities
IfcAppliedValue	Entities
IfcCableSegmentType	Entities
IfcTable	Entities
IfcCoolingTower	Entities
IfcBuildingElementPartType	Entities
IfcCompressorTypeEnum	Types
IfcGridTypeEnum	Types
IfcBinary	Types
IfcWorkSchedule	Entities
IfcPresentationStyleAssignment	Entities
IfcOutletType	Entities
IfcLightSource	Entities
IfcCurveBoundedSurface	Entities
IfcSectionProperties	Entities
IfcAxis2Placement2D	Entities
IfcSegmentIndexSelect	Types
IfcDiscreteAccessoryTypeEnum	Types
IfcColourRgbList	Entities
IfcPropertySetDefinitionSet	Types
IfcLaborResourceType	Entities
IfcDistributionPort	Entities
IfcGridAxis	Entities
IfcObjectPlacement	Entities
IfcBoundaryNodeCondition	Entities
IfcConstraint	Entities
IfcCommunicationsAppliance	Entities
IfcSubContractResourceTypeEnum	Types
IfcDataOriginEnum	Types
IfcVector_List	Other
IfcElectricCapacitanceMeasure	Types
IfcEngine	Entities
IfcLightDistributionData_EmptyList	Other
IfcApprovalRelationship	Entities
IfcCurveStyleFontSelect	Types
IfcCooledBeam	Entities
IfcBuildingElementProxyTypeEnum	Types
IfcChangeActionEnum	Types
IfcMaterialUsageDefinition	Entities
IfcParameterizedProfileDef	Entities
IfcMaterialProfileSet	Entities
IfcWorkScheduleTypeEnum	Types
IfcLightFixtureTypeEnum	Types
IfcMetricValueSelect	Types
IfcPumpTypeEnum	Types
IfcStructuralLoadGroup	Entities
IfcStructuralLoadConfiguration	Entities
IfcDuctFittingType	Entities
IfcDocumentConfidentialityEnum	Types
IfcFlowDirectionEnum	Types
IfcCompositeCurveSegment_EmptyList	Other
IfcReinforcingBarRoleEnum	Types
IfcCircle	Entities
IfcModulusOfSubgradeReactionSelect	Types
IfcPresentationItem	Entities
IfcAppliedValueSelect	Types
IfcNormalisedRatioMeasure_List	Other
IfcTextPath	Types
IfcInventory	Entities
IfcCoveringType	Entities
IfcElectricApplianceTypeEnum	Types
IfcLoadGroupTypeEnum	Types
IfcFillAreaStyleHatching	Entities
IfcMirroredProfileDef	Entities
IfcDoorPanelOperationEnum	Types
IfcComplexPropertyTemplateTypeEnum	Types
IfcColourOrFactor	Types
IfcBoundaryEdgeCondition	Entities
IfcRelationship	Entities
IfcLengthMeasure_List_List	Other
IfcPropertyEnumeratedValue	Entities
IfcStructuralCurveConnection	Entities
IfcDerivedUnitElement	Entities
IfcUnitaryEquipment	Entities
IfcInternalOrExternalEnum	Types
IfcConic	Entities
IfcEvaporatorTypeEnum	Types
IfcColumnTypeEnum	Types
IfcAxis2Placement	Types
IfcObjectDefinition_EmptyList	Other
IfcOccupant	Entities
IfcEvaporativeCooler	Entities
IfcWorkPlanTypeEnum	Types
IfcStructuralPointAction	Entities
IfcFontWeight	Types
IfcQuantityWeight	Entities
IfcTransformer	Entities
IfcTemperatureGradientMeasure	Types
IfcObjectDefinition	Entities
IfcBuildingSystem	Entities
IfcProductRepresentation	Entities
IfcActor	Entities
IfcColumn	Entities
IfcProfileDef	Entities
IfcExternalSpatialStructureElement	Entities
IfcCompositeCurveOnSurface	Entities
IfcComplexNumber	Types
IfcLogical	Types
IfcLuminousIntensityDistributionMeasure_EmptyList	Other
IfcZone	Entities
IfcTendonType	Entities
IfcTableRow_List	Other
IfcTank	Entities
IfcConstructionProductResource	Entities
IfcFastenerTypeEnum	Types
IfcSpecularExponent	Types
IfcMaterialSelect	Types
IfcBuildingElementProxyType	Entities
IfcConstraintEnum	Types
IfcRelAssignsToGroup	Entities
IfcRelAssociates	Entities
IfcInteger_List	Other
IfcOpeningElementTypeEnum	Types
IfcWasteTerminal	Entities
IfcPerson	Entities
IfcSweptDiskSolid	Entities
IfcAnnotationFillArea	Entities
IfcRevolvedAreaSolidTapered	Entities
IfcLagTime	Entities
IfcMeasureWithUnit	Entities
IfcWarpingConstantMeasure	Types
IfcShearModulusMeasure	Types
IfcPipeSegmentTypeEnum	Types
IfcCurveStyle	Entities
IfcIonConcentrationMeasure	Types
IfcBoundingBox	Entities
IfcBoundaryNodeConditionWarping	Entities
IfcPressureMeasure	Types
IfcLineIndex	Types
IfcSlippageConnectionCondition	Entities
IfcCartesianTransformationOperator2DnonUniform	Entities
IfcAnalysisModelTypeEnum	Types
IfcBuildingElementProxy	Entities
IfcCartesianTransformationOperator	Entities
IfcLanguageId	Types
IfcRightCircularCylinder	Entities
IfcRelSequence	Entities
IfcActuatorType	Entities
IfcDuctFitting	Entities
IfcSegmentIndexSelect_List	Other
IfcHatchLineDistanceSelect	Types
IfcDistributionElement	Entities
IfcSolidOrShell	Types
IfcHumidifierType	Entities
IfcSectionalAreaIntegralMeasure	Types
IfcCableSegment	Entities
IfcIndexedPolygonalFace_List	Other
IfcMechanicalFastenerType	Entities
IfcChimney	Entities
IfcTrimmedCurve	Entities
IfcBuildingElement	Entities
IfcCurveStyleFontPattern_List	Other
IfcStructuralSurfaceMember	Entities
IfcAxis1Placement	Entities
IfcPositiveInteger_EmptyList	Other
IfcMagneticFluxDensityMeasure	Types
IfcSurfaceStyleRendering	Entities
IfcParameterValue_List_EmptyList	Other
IfcAirTerminalType	Entities
IfcBSplineSurfaceForm	Types
IfcSurfaceCurveSweptAreaSolid	Entities
IfcJunctionBoxTypeEnum	Types
IfcEventType	Entities
IfcUnitaryEquipmentTypeEnum	Types
IfcSphericalSurface	Entities
IfcSphere	Entities
IfcBoundaryCurve	Entities
IfcCartesianPoint	Entities
IfcFastenerType	Entities
IfcRelDefinesByObject	Entities
IfcTaskTypeEnum	Types
IfcFace	Entities
IfcDoorStyleConstructionEnum	Types
IfcAirToAirHeatRecoveryTypeEnum	Types
IfcTime	Types
IfcBurnerType	Entities
IfcFrequencyMeasure	Types
IfcActionTypeEnum	Types
IfcRoundedRectangleProfileDef	Entities
IfcTextFontName_EmptyList	Other
IfcExternallyDefinedSurfaceStyle	Entities
IfcTableColumn	Entities
IfcCoveringTypeEnum	Types
IfcSurface	Entities
IfcDocumentInformationRelationship	Entities
IfcLightDistributionDataSourceSelect	Types
IfcTrimmingPreference	Types
IfcPHMeasure	Types
IfcObjectiveEnum	Types
IfcSoundPowerLevelMeasure	Types
IfcSimplePropertyTemplateTypeEnum	Types
IfcAddress	Entities
IfcCurveFontOrScaledCurveFontSelect	Types
IfcTextureCoordinateGenerator	Entities
IfcPropertyTemplateDefinition	Entities
IfcRightCircularCone	Entities
IfcCenterLineProfileDef	Entities
IfcLightDistributionData	Entities
IfcKinematicViscosityMeasure	Types
IfcShadingDeviceType	Entities
IfcConstraint_EmptyList	Other
IfcEllipseProfileDef	Entities
IfcRelSpaceBoundary1stLevel	Entities
IfcBoilerType	Entities
IfcExternalInformation	Entities
IfcInteger	Types
IfcObjectReferenceSelect	Types
IfcRelAssigns	Entities
IfcAppliedValue_EmptyList	Other
IfcLuminousFluxMeasure	Types
IfcFilter	Entities
IfcVirtualGridIntersection	Entities
IfcRelConnectsPorts	Entities
IfcRelConnectsStructuralMember	Entities
IfcConstraint_List	Other
IfcWindowLiningProperties	Entities
IfcMotorConnectionType	Entities
IfcHeatingValueMeasure	Types
IfcGridPlacementDirectionSelect	Types
IfcURIReference_List	Other
IfcWindowPanelPositionEnum	Types
IfcDocumentStatusEnum	Types
IfcObject	Entities
IfcTendonAnchor	Entities
IfcPileConstructionEnum	Types
IfcHumidifierTypeEnum	Types
IfcStructuralLoadOrResult_List	Other
IfcDamper	Entities
IfcCurve	Entities
IfcDistributionElementType	Entities
IfcBoxedHalfSpace	Entities
IfcColumnStandardCase	Entities
IfcCountMeasure	Types
IfcTemperatureRateOfChangeMeasure	Types
IfcRectangularPyramid	Entities
IfcPositiveInteger	Types
IfcPermeableCoveringProperties	Entities
IfcDuration	Types
IfcFlowTreatmentDeviceType	Entities
IfcFan	Entities
IfcTextStyleForDefinedFont	Entities
IfcConstructionEquipmentResourceType	Entities
IfcBlobTexture	Entities
IfcCoilType	Entities
IfcSensorTypeEnum	Types
IfcCurveStyleFont	Entities
IfcClassificationReference	Entities
IfcShapeRepresentation	Entities
IfcReinforcingBarSurfaceEnum	Types
IfcTextFontName_List	Other
IfcCrewResource	Entities
IfcStructuralConnectionCondition	Entities
IfcRecurrenceTypeEnum	Types
IfcStructuralCurveReaction	Entities
IfcFlowMovingDeviceType	Entities
IfcTransportElementType	Entities
IfcElectricGenerator	Entities
IfcCoil	Entities
IfcSIPrefix	Types
IfcWarpingStiffnessSelect	Types
IfcIsothermalMoistureCapacityMeasure	Types
IfcRamp	Entities
IfcRelAssociatesDocument	Entities
IfcWasteTerminalType	Entities
IfcCartesianTransformationOperator2D	Entities
IfcElectricAppliance	Entities
IfcMaterialProperties	Entities
IfcVertexLoop	Entities
IfcSystemFurnitureElement	Entities
IfcStructuralLoadCase	Entities
IfcPlateType	Entities
IfcSweptDiskSolidPolygonal	Entities
IfcFaceBasedSurfaceModel	Entities
IfcWorkPlan	Entities
IfcClosedShell	Entities
IfcMechanicalFastener	Entities
IfcWindow	Entities
IfcTelecomAddress	Entities
IfcConnectionPointGeometry	Entities
IfcMolecularWeightMeasure	Types
IfcConstructionProductResourceType	Entities
IfcOffsetCurve3D	Entities
IfcValve	Entities
IfcDocumentReference	Entities
IfcCivilElementType	Entities
IfcBooleanOperator	Types
IfcSolidModel	Entities
IfcCivilElement	Entities
IfcShapeModel_EmptyList	Other
IfcLayeredItem	Types
IfcDoorType	Entities
IfcSpatialStructureElementType	Entities
IfcElementType	Entities
IfcMaterialLayer_List	Other
IfcPropertyEnumeration	Entities
IfcPixelTexture	Entities
IfcProperty	Entities
IfcTransitionCode	Types
IfcBSplineSurface	Entities
IfcProcedureTypeEnum	Types
IfcPostalAddress	Entities
IfcRectangularTrimmedSurface	Entities
IfcStructuralLoadStatic	Entities
IfcDuctFittingTypeEnum	Types
IfcSimpleProperty	Entities
IfcNormalisedRatioMeasure	Types
IfcCrewResourceTypeEnum	Types
IfcDate	Types
IfcFurnishingElement	Entities
IfcURIReference_EmptyList	Other
IfcStyleAssignmentSelect	Types
IfcLinearStiffnessMeasure	Types
IfcStructuralSurfaceMemberTypeEnum	Types
IfcStructuralLoadSingleForceWarping	Entities
IfcEdgeCurve	Entities
IfcStructuralPlanarAction	Entities
IfcHalfSpaceSolid	Entities
IfcLengthMeasure	Types
IfcParameterValue_List_List	Other
IfcPcurve_EmptyList	Other
IfcLine	Entities
IfcStructuralLoadSingleForce	Entities
IfcVector_EmptyList	Other
IfcDerivedProfileDef	Entities
IfcSwitchingDeviceTypeEnum	Types
IfcMaterialProfileSetUsage	Entities
IfcSensorType	Entities
IfcChiller	Entities
IfcRelConnectsPortToElement	Entities
IfcBooleanOperand	Types
IfcHeatFluxDensityMeasure	Types
IfcTimeSeriesValue	Entities
IfcOuterBoundaryCurve	Entities
IfcFlowSegmentType	Entities
IfcRelNests	Entities
IfcExtrudedAreaSolidTapered	Entities
IfcBSplineCurve	Entities
IfcSpaceType	Entities
IfcLibraryInformation	Entities
IfcDraughtingPreDefinedCurveFont	Entities
IfcSoundPowerMeasure	Types
IfcReinforcementBarProperties	Entities
IfcFurniture	Entities
IfcWorkTime	Entities
IfcLightDistributionCurveEnum	Types
IfcElectricCurrentMeasure	Types
IfcSwitchingDevice	Entities
IfcDistributionChamberElementTypeEnum	Types
IfcRepresentationMap_List	Other
IfcControllerType	Entities
IfcReinforcingElement	Entities
IfcLightDistributionData_List	Other
IfcTransformerType	Entities
IfcBSplineCurveWithKnots	Entities
IfcWallElementedCase	Entities
IfcSite	Entities
IfcMappedItem	Entities
IfcFacetedBrepWithVoids	Entities
IfcBSplineSurfaceWithKnots	Entities
IfcConstructionMaterialResourceType	Entities
IfcStructuralSurfaceAction	Entities
IfcStructuralAnalysisModel	Entities
IfcGeometricRepresentationContext	Entities
IfcResourceTime	Entities
IfcStructuralCurveMemberTypeEnum	Types
IfcBuildingSystemTypeEnum	Types
IfcRelSpaceBoundary2ndLevel	Entities
IfcArbitraryProfileDefWithVoids	Entities
IfcLogicalOperatorEnum	Types
IfcManifoldSolidBrep	Entities
IfcProtectiveDeviceTrippingUnitTypeEnum	Types
IfcRepresentation_List	Other
IfcUnitaryControlElementTypeEnum	Types
IfcTShapeProfileDef	Entities
IfcCurveStyleFontAndScaling	Entities
IfcVibrationIsolatorTypeEnum	Types
IfcProject	Entities
IfcPolyLoop	Entities
IfcSectionModulusMeasure	Types
IfcAirTerminal	Entities
IfcAdvancedBrepWithVoids	Entities
IfcSolidAngleMeasure	Types
IfcRoot	Entities
IfcRationalBSplineCurveWithKnots	Entities
IfcProtectiveDeviceTrippingUnit	Entities
IfcAdvancedBrep	Entities
IfcSurfaceOfLinearExtrusion	Entities
IfcQuantityVolume	Entities
IfcVoidingFeature	Entities
IfcCondenser	Entities
IfcPresentationStyleSelect	Types
IfcCoolingTowerType	Entities
IfcElementarySurface	Entities
IfcSubedge	Entities
IfcWindowTypeEnum	Types
IfcPowerMeasure	Types
IfcBeamType	Entities
IfcAssemblyPlaceEnum	Types
IfcWindowStyle	Entities
IfcMaterialRelationship	Entities
IfcMedicalDeviceType	Entities
IfcSurfaceTexture_List	Other
IfcElectricMotorType	Entities
IfcSystem	Entities
IfcLightFixture	Entities
IfcBurner	Entities
IfcSurfaceTexture_EmptyList	Other
IfcRotationalFrequencyMeasure	Types
IfcCsgPrimitive3D	Entities
IfcSanitaryTerminalType	Entities
IfcIdentifier_List	Other
IfcAreaDensityMeasure	Types
IfcReal_List	Other
IfcTextureMap	Entities
IfcTextFontSelect	Types
IfcPropertySetTemplateTypeEnum	Types
IfcCondenserType	Entities
IfcPolyline	Entities
IfcFlowStorageDeviceType	Entities
IfcActionSourceTypeEnum	Types
IfcRoofType	Entities
IfcExternalSpatialElementTypeEnum	Types
IfcShadingDeviceTypeEnum	Types
IfcTypeProcess	Entities
IfcConnectedFaceSet	Entities
IfcStructuralSurfaceReaction	Entities
IfcSlabTypeEnum	Types
IfcTrimmingSelect	Types
IfcRelAssociatesClassification	Entities
IfcPositiveInteger_List_EmptyList	Other
IfcCableCarrierSegment	Entities
IfcComplexPropertyTemplate	Entities
IfcFlowSegment	Entities
IfcPile	Entities
IfcDoorPanelProperties	Entities
IfcParameterValue	Types
IfcPermitTypeEnum	Types
IfcEngineTypeEnum	Types
IfcElementQuantity	Entities
IfcObjectDefinition_List	Other
IfcActorRole_List	Other
IfcBoundaryFaceCondition	Entities
IfcExtrudedAreaSolid	Entities
IfcLocalPlacement	Entities
IfcPolygonalBoundedHalfSpace	Entities
IfcSolarDevice	Entities
IfcParameterValue_EmptyList	Other
IfcPerformanceHistory	Entities
IfcOutlet	Entities
IfcStructuralCurveActivityTypeEnum	Types
IfcPipeSegment	Entities
IfcMagneticFluxMeasure	Types
IfcCurtainWallTypeEnum	Types
IfcIdentifier_EmptyList	Other
IfcMaterial_List	Other
IfcRelConnectsStructuralActivity	Entities
IfcSwitchingDeviceType	Entities
IfcPreDefinedProperties	Entities
IfcStairTypeEnum	Types
IfcReinforcementDefinitionProperties	Entities
IfcRelConnectsWithEccentricity	Entities
IfcElementCompositionEnum	Types
IfcResourceLevelRelationship	Entities
IfcFanTypeEnum	Types
IfcPresentationLayerAssignment	Entities
IfcElectricFlowStorageDevice	Entities
IfcSensor	Entities
IfcProjectedCRS	Entities
IfcIndexedPolygonalFace_EmptyList	Other
IfcFixedReferenceSweptAreaSolid	Entities
IfcMassDensityMeasure	Types
IfcPcurve_List	Other
IfcSectionTypeEnum	Types
IfcRecurrencePattern	Entities
IfcRelReferencedInSpatialStructure	Entities
IfcStructuralPointConnection	Entities
IfcRevolvedAreaSolid	Entities
IfcWorkControl	Entities
IfcTankTypeEnum	Types
IfcRelAssignsToProcess	Entities
IfcCurveBoundedPlane	Entities
IfcInventoryTypeEnum	Types
IfcUnit	Types
IfcFlowMeter	Entities
IfcSurfaceSide	Types
IfcPcurve	Entities
IfcMaterialClassificationRelationship	Entities
IfcWindowType	Entities
IfcEvaporativeCoolerType	Entities
IfcTendonAnchorTypeEnum	Types
IfcFurnitureTypeEnum	Types
IfcPropertySetDefinitionSelect	Types
IfcFillAreaStyleTiles	Entities
IfcQuantityCount	Entities
IfcToroidalSurface	Entities
IfcElementComponentType	Entities
IfcPhysicalComplexQuantity	Entities
IfcGeographicElementTypeEnum	Types
IfcStructuralLinearAction	Entities
IfcBeamTypeEnum	Types
IfcTextStyleTextModel	Entities
IfcFlowMeterTypeEnum	Types
IfcPointOnCurve	Entities
IfcDistributionFlowElement	Entities
IfcShadingDevice	Entities
IfcObjective	Entities
IfcPositiveInteger_List_List	Other
IfcFlowTreatmentDevice	Entities
IfcRelAssociatesMaterial	Entities
IfcContextDependentUnit	Entities
IfcGeometricProjectionEnum	Types
IfcSpatialZone	Entities
IfcElectricApplianceType	Entities
IfcWallTypeEnum	Types
IfcRampTypeEnum	Types
IfcDateTime	Types
IfcMassPerLengthMeasure	Types
IfcTendonTypeEnum	Types
IfcUShapeProfileDef	Entities
IfcHeatExchanger	Entities
IfcOwnerHistory	Entities
IfcCrewResourceType	Entities
IfcCableFitting	Entities
IfcDistributionChamberElementType	Entities
IfcReal_List_EmptyList	Other
IfcProjectLibrary	Entities
IfcRepresentationMap_EmptyList	Other
IfcDoorTypeEnum	Types
IfcMemberType	Entities
IfcMaterialDefinitionRepresentation	Entities
IfcURIReference	Types
IfcRailing	Entities
IfcFillAreaStyle	Entities
IfcVertex	Entities
IfcSchedulingTime	Entities
IfcInductanceMeasure	Types
IfcModulusOfLinearSubgradeReactionMeasure	Types
IfcPort	Entities
IfcProjectionElement	Entities
IfcFilterType	Entities
IfcFooting	Entities
IfcActionRequestTypeEnum	Types
IfcCoordinateReferenceSystemSelect	Types
IfcPropertySetTemplate	Entities
IfcRatioMeasure	Types
IfcPhysicalQuantity_List	Other
IfcGeometricSetSelect	Types
IfcIlluminanceMeasure	Types
IfcOccupantTypeEnum	Types
IfcSizeSelect	Types
IfcAlarmType	Entities
IfcDerivedMeasureValue	Types
IfcAnnotation	Entities
IfcTimeSeriesValue_EmptyList	Other
IfcPreDefinedItem	Entities
IfcVaporPermeabilityMeasure	Types
IfcMassFlowRateMeasure	Types
IfcPath	Entities
IfcAudioVisualApplianceTypeEnum	Types
IfcSectionReinforcementProperties_EmptyList	Other
IfcRelAssociatesConstraint	Entities
IfcWindowStyleOperationEnum	Types
IfcBeam	Entities
IfcExternalReferenceRelationship	Entities
IfcElectricMotor	Entities
IfcOpenShell	Entities
IfcRelAssignsToControl	Entities
IfcApplication	Entities
IfcGeometricCurveSet	Entities
IfcSpaceTypeEnum	Types
IfcTopologyRepresentation	Entities
IfcObjectTypeEnum	Types
IfcPresentationStyle	Entities
IfcSpaceHeaterType	Entities
IfcQuantityArea	Entities
IfcBuildingElementType	Entities
IfcElectricFlowStorageDeviceType	Entities
IfcIShapeProfileDef	Entities
IfcBuildingStorey	Entities
IfcDerivedUnit	Entities
IfcGridAxis_List	Other
IfcAlarmTypeEnum	Types
IfcSubContractResource	Entities
IfcCompositeCurve	Entities
IfcValveType	Entities
IfcTableColumn_EmptyList	Other
IfcMaterialProfileSetUsageTapering	Entities
IfcLightSourceDirectional	Entities
IfcEdgeLoop	Entities
IfcWarpingMomentMeasure	Types
IfcBoiler	Entities
IfcRelDefinesByType	Entities
IfcSIUnitName	Types
IfcVertexPoint	Entities
IfcDoorStyleOperationEnum	Types
IfcFontVariant	Types
IfcUnitaryControlElement	Entities
IfcDistributionChamberElement	Entities
IfcBurnerTypeEnum	Types
IfcAdvancedFace	Entities
IfcCableCarrierFittingType	Entities
IfcProfileDef_List	Other
IfcFootingTypeEnum	Types
IfcActorRole	Entities
IfcCoolingTowerTypeEnum	Types
IfcCircleHollowProfileDef	Entities
IfcTriangulatedFaceSet	Entities
IfcPlate	Entities
IfcArbitraryClosedProfileDef	Entities
IfcCurveInterpolationEnum	Types
IfcSpaceHeater	Entities
IfcTimeSeriesDataTypeEnum	Types
IfcRelAggregates	Entities
IfcRelCoversSpaces	Entities
IfcElectricFlowStorageDeviceTypeEnum	Types
IfcTaskDurationEnum	Types
IfcGrid	Entities
IfcModulusOfRotationalSubgradeReactionSelect	Types
IfcValue	Types
IfcSolarDeviceTypeEnum	Types
IfcMetric	Entities
IfcModulusOfElasticityMeasure	Types
IfcRelDefinesByTemplate	Entities
IfcVectorOrDirection	Types
IfcEdge	Entities
IfcAmountOfSubstanceMeasure	Types
IfcVector	Entities
IfcDoorTypeOperationEnum	Types
IfcLibrarySelect	Types
IfcShellBasedSurfaceModel	Entities
IfcTaskType	Entities
IfcValue_List	Other
IfcPipeSegmentType	Entities
IfcTorqueMeasure	Types
IfcWorkCalendarTypeEnum	Types
IfcFilterTypeEnum	Types
IfcRoof	Entities
IfcDistributionSystem	Entities
IfcPlateTypeEnum	Types
IfcLightSourcePositional	Entities
IfcSpaceHeaterTypeEnum	Types
IfcChimneyType	Entities
IfcElectricResistanceMeasure	Types
IfcBendingParameterSelect	Types
IfcRationalBSplineSurfaceWithKnots	Entities
IfcMonthInYearNumber	Types
IfcElectricDistributionBoard	Entities
IfcMoistureDiffusivityMeasure	Types
IfcConstructionMaterialResourceTypeEnum	Types
IfcStructuralSurfaceConnection	Entities
IfcLamp	Entities
IfcIndexedTextureMap	Entities
IfcReference	Entities
